A    *      *
     * **** *
* * ** *  * *
  *      * 
*** * * *  *
B  * * *   *
           *
***********